30
30
10
10
1
1
0 1 4 1 4 1 0 1 4 1 4 1 4 1 4 1 0 1 4 1 4 1 4 4 1 4 1 4 1 0
2 d 3 3 3 8 2 3 8 3 3 3 3 3 3 8 2 8 3 3 3 3 3 3 3 3 3 3 8 2
5 3 3 3 3 3 2 3 3 3 3 3 3 3 3 3 2 3 3 3 3 3 3 3 3 3 3 3 3 5
5 3 3 3 3 3 2 3 3 3 3 3 3 3 3 3 2 3 3 3 3 3 3 3 3 3 3 3 3 2
2 8 3 3 3 8 2 3 3 3 3 3 3 3 3 3 7 3 3 3 3 3 3 3 3 3 3 3 3 2
0 1 6 1 1 1 0 0 3 3 3 3 3 3 3 3 2 3 3 3 3 3 3 3 3 3 3 3 3 5
2 8 3 3 3 3 8 2 8 3 3 3 3 3 3 8 2 8 3 3 3 3 3 3 3 3 3 3 8 2
5 3 3 3 3 3 3 0 1 1 6 1 1 0 1 1 0 1 1 1 6 1 1 1 1 1 1 1 1 0
2 3 3 3 3 3 3 2 8 3 3 3 8 2 8 c c c c c c c c c c c c c 8 2
5 3 3 3 3 3 3 2 3 3 3 3 3 2 c 3 3 3 3 3 3 3 3 3 3 3 3 3 c 5
2 3 3 3 3 3 3 2 3 3 8 3 3 2 c 3 3 8 c c c c c c c c c c 8 2
5 3 3 3 3 3 3 2 3 3 3 3 3 2 c 3 3 c 0 1 1 1 1 1 1 1 1 1 1 0
2 8 3 3 3 3 8 2 8 3 3 3 8 2 c 3 3 c 2 8 9 9 9 9 9 9 9 9 8 2
0 1 6 1 1 1 1 0 0 1 1 1 1 0 c 3 3 c 2 9 3 3 3 3 3 3 3 3 9 0
2 8 3 3 3 3 3 8 2 8 3 3 8 2 c 3 3 c 2 9 3 3 3 3 8 9 3 9 8 2
5 3 3 3 3 3 3 3 2 3 3 3 3 2 c 3 3 c 2 9 3 3 3 3 9 0 6 1 1 0
5 3 3 3 3 3 3 3 2 3 3 3 3 2 c 3 3 c 2 9 3 3 3 3 9 2 3 3 8 2
2 8 3 3 3 3 3 3 7 3 3 3 3 2 c 3 3 c 7 9 3 3 3 3 9 0 0 3 3 5
0 1 1 1 1 1 1 1 0 3 3 3 3 2 c 3 3 c 2 9 3 3 3 3 9 8 2 3 3 2
2 8 3 3 3 3 3 3 3 8 3 3 3 2 c 3 3 c 2 9 3 3 3 3 9 3 2 3 3 5
5 3 3 3 3 3 3 3 3 3 3 3 3 2 c 3 3 c 2 9 3 3 3 3 9 3 2 3 3 2
2 8 3 3 3 3 3 3 3 3 3 3 8 2 c 3 3 c 2 9 3 3 3 3 9 3 2 3 3 5
0 1 1 1 6 1 1 1 0 1 1 0 1 0 c 3 3 c 2 9 3 3 3 3 9 3 2 3 3 2
2 8 a a 3 8 a a 2 3 8 2 c 8 c 3 3 8 2 8 9 9 9 9 3 8 2 3 3 5
5 a 3 3 3 3 3 a 2 3 a 0 1 1 1 1 1 1 0 1 1 1 1 1 1 1 0 3 3 2
2 a 3 3 a 2 3 a 2 3 3 2 8 b b b b b b b b b b b b 8 2 3 3 5
2 a 3 3 a 2 3 a 2 3 3 7 b 3 3 3 3 3 3 3 3 3 3 3 3 b 2 3 3 2
5 a 3 3 a 2 3 3 3 3 a 2 b 3 3 3 3 3 3 3 3 3 3 3 3 b 7 3 3 5
2 8 a a a 2 3 3 8 3 8 2 8 b b b b b b b b b b b b 8 2 8 8 2
0 1 4 4 1 0 1 4 4 1 1 0 1 4 1 4 1 4 1 1 4 1 4 1 4 1 0 4 4 0
8
6
15
6
28
16
19
29
12
29
1
19
endlvl