20
20
1
1
18
18
0 1 1 4 1 1 0 4 1 1 1 4 1 0 1 4 1 1 1 0
2 8 3 3 3 3 2 b 3 3 3 3 b 2 3 3 3 3 8 2
2 3 3 3 3 3 2 3 3 3 3 3 3 7 3 3 3 3 3 2
5 3 3 3 3 3 7 3 3 3 3 3 3 2 3 3 3 3 3 5
2 3 3 3 3 3 2 3 3 3 3 3 3 2 3 3 3 3 3 2
0 1 1 1 1 1 0 1 1 1 6 1 1 0 1 1 6 1 1 0
2 b c c c c c c c c 3 c c c c c 3 3 b 2
5 3 3 3 3 3 3 3 3 3 3 3 3 3 3 3 3 3 3 5
2 3 3 3 3 3 3 3 3 3 3 3 3 3 3 3 3 3 3 2
2 3 3 3 3 3 3 3 3 3 3 3 3 3 3 3 3 3 3 2
2 3 3 3 3 3 3 3 3 3 3 3 3 3 3 3 3 3 3 2
5 b 3 3 3 3 3 3 3 3 3 3 3 3 3 3 3 3 b 5
0 1 1 1 1 1 1 0 3 3 3 3 3 3 0 1 1 1 1 0
2 3 9 9 9 3 3 2 3 3 3 3 3 3 2 a a a 3 2
2 3 3 3 3 3 3 2 3 3 3 3 3 3 2 3 3 3 3 2
5 3 3 3 3 3 3 7 3 3 3 3 3 3 7 3 3 3 3 5
2 8 3 3 3 3 3 2 3 3 3 3 3 3 2 3 3 3 3 2
0 1 1 1 1 1 1 0 3 3 3 3 3 3 0 1 1 1 1 0
2 8 3 3 3 3 3 3 3 3 3 3 3 3 3 3 3 3 d 2
0 1 1 4 1 1 1 4 1 1 1 4 1 1 1 4 1 1 1 0
18
7
1
7
endlvl