20
20
18
18
1
1
0 4 0 1 1 0 1 1 0 4 1 0 1 1 0 1 1 0 4 0
2 d 2 8 3 7 3 8 2 8 3 7 3 8 2 8 3 7 8 2
2 3 2 3 3 2 3 3 2 3 3 2 3 3 2 3 3 2 3 2
5 3 2 c 3 2 b 3 2 3 a 2 9 3 2 3 3 2 3 5
2 3 2 c 3 2 b 3 2 3 a 2 9 3 2 3 3 2 3 2
2 3 2 c 3 2 b 3 2 3 a 2 9 3 2 3 3 2 3 2
2 3 2 3 3 2 3 3 2 3 3 2 3 3 2 3 3 2 3 2
2 3 2 3 3 2 3 3 2 3 3 2 3 3 2 3 3 2 3 2
5 3 2 c 3 2 b 3 2 3 a 2 9 3 2 3 3 2 3 5
2 3 2 c 3 2 b 3 2 3 a 2 9 3 2 3 3 2 3 2
2 3 2 c 3 2 b 3 2 3 a 2 9 3 2 3 3 2 3 2
2 3 2 3 3 2 3 3 2 3 3 2 3 3 2 3 3 2 3 2
5 3 2 3 3 2 3 3 2 3 3 2 3 3 2 3 3 2 3 5
2 3 2 3 3 2 3 3 2 3 3 2 3 3 2 3 3 2 3 2
2 3 2 c 3 2 b 3 2 3 a 2 9 3 2 3 3 2 3 2
2 3 2 c 3 2 b 3 2 3 a 2 9 3 2 3 3 2 3 2
5 3 2 c 3 2 b 3 2 3 a 2 9 3 2 3 3 2 3 5
2 3 2 3 3 2 3 3 2 3 3 2 3 3 2 3 3 2 3 2
2 8 7 3 8 2 8 3 7 3 8 2 8 3 7 3 8 2 3 2
0 4 0 1 1 0 1 1 0 1 4 0 1 1 0 1 1 0 4 0
1
3
18
3
1
17
18
17
1
11
18
11
endlvl