30
20
1
1
13
12
0 4 1 1 1 4 0 1 1 4 4 1 1 0 1 1 4 1 1 0
5 8 3 3 3 8 2 8 c 3 3 c 8 2 8 3 3 3 8 2
2 9 3 3 3 3 2 a 3 3 3 3 3 7 3 3 3 3 9 5
2 9 3 3 3 3 2 a 3 3 3 3 a 2 3 3 3 3 9 2
2 9 3 3 3 3 2 a 3 3 3 3 a 2 3 3 3 3 9 2
2 9 3 3 3 3 2 a 3 3 3 3 a 2 3 3 3 3 9 2
2 9 3 3 3 3 2 a 3 3 3 3 a 2 3 3 3 3 9 5
5 9 3 3 3 3 2 8 a a a a 3 2 8 3 3 3 9 2
2 9 3 3 3 3 0 1 1 1 1 0 6 0 0 8 3 3 9 2
2 9 3 3 3 3 2 8 c c 8 2 3 3 0 0 8 3 9 2
2 9 3 3 3 3 2 3 3 3 3 2 3 3 3 2 3 3 8 5
5 9 3 3 3 3 2 3 3 3 3 0 1 6 1 0 6 1 1 0
2 9 3 3 3 3 2 3 3 3 3 2 8 3 8 2 3 3 8 5
2 9 3 3 3 3 2 8 c c 8 2 3 d 3 2 3 3 b 2
5 9 3 3 3 3 0 1 1 1 6 0 8 3 8 2 3 3 3 2
2 9 3 3 3 8 3 3 3 3 3 0 1 1 1 0 3 3 b 2
2 9 3 3 3 3 3 3 3 3 3 2 8 3 3 3 8 3 3 2
5 8 3 3 3 3 3 3 3 3 8 2 b 3 3 3 3 3 b 5
0 1 1 1 6 1 1 1 1 1 1 0 3 3 3 3 3 3 3 2
2 8 3 3 3 3 3 3 3 3 8 2 b 3 3 3 3 3 b 2
2 b 3 3 3 3 3 3 3 3 b 2 3 3 3 3 3 3 3 2
5 3 3 3 3 3 3 3 3 3 b 2 b 3 3 3 3 3 b 2
2 b 3 3 3 3 3 3 3 3 b 2 8 3 3 3 3 3 8 5
2 b 3 3 3 3 3 3 3 3 b 0 1 1 1 6 1 1 1 0
5 3 3 3 3 3 3 3 3 3 8 2 8 3 3 3 3 3 8 2
0 6 1 1 1 1 1 1 1 1 1 2 3 3 3 3 3 3 3 5
2 8 3 3 3 3 3 3 3 3 8 7 3 3 3 3 3 3 3 2
5 3 3 3 3 3 3 3 3 3 3 2 3 3 3 3 3 3 3 5
2 8 3 c c c 3 c c c 8 2 8 c 3 c c 3 8 2
0 1 4 1 1 1 4 1 1 1 4 0 1 1 4 1 1 4 1 0
2
7
9
17
11
19
17
14
1
18
7
6
endlvl